CCXXXXXXCC
XCCCCCCCCX
XC      CX
XC      CX
XC CXXC CX
XC CXXC CX
XC      CX
XC      CX
XCCCCC  EC
CCXXXXXC C
