SSSSSSSSSS
SXb C    S
S S SC   S
C   XSsssS
C   s    S
C     OS S
C  C   C S
S   O SX S
S      SES
SSSSSSSSSS
