CCCCCCCCCC
CXb X    C
C C CX   C
X  CXCCCCC
X   CC   C
X     OC C
XsCX   X C
C   O CX C
Cbb    CEC
CCCCCCCCCC
