##########
#X  X   X#
#     P  #
#   C    #
# P P  p #
#P P P # #
# C    #C#
#      b #
#OOOOOO#E#
##########