OOOOOO###O
OOOO###E#O
OO###  C#O
##      #O
#X      #O
##O     ##
#X C     #
##P#OPPPO#
# C     XO
#   ######