SSSSSSSSSS
SX b  #  S
S S      S
S   C ssXS
S   s    S
S      S S
SX C   SCS
S     OS S
S  s   SES
SSSSSSSSSS