OO########
OO#XXXXXX#
OO#   C C#
OO#  ##C #
OO#C# C  #
OO#      #
OO# pp C#O
OO# pb   # 
O#E ppp  #
O#########