OOO###OOOO
OOO#X#OOOO
OOO# #OOOO
####C####O
#X CEC X#O
####C####O
OOO# #OOOO 
OOO#X#OOOO
OOO###OOOO
OOOOOOOOOO