####OO####
#b POOP b#
#  POOC  #
#  COOP  #
#  POOC  #
#        #
#  POOC  #
#XXPOOP  #
#XXPOOP E#
##########