#########O
#X#X#  E#O
# # # # #O
# C # C #O
# # # # #O
#     C #O
# C # # #O
# # # # #O
#X#X#b# #O
#########O