##########
#b  X   X#
# S      #
#   C    #
#   s    #
#      # #
#  C   #C#
#     O# #
#  X   #E#
##########
